0000000000000000000000000000
0000000000000011111111111110
0000000000000011111111111110
1111111111111111111111111110
1111111111111111111111111110
1111111111111111111111111110
1111111111111111111111111110
0000000000000011111111111110
0000000000000011111111111110
0000000000000000000000000000