000000000000000000000000000000000000000000000000000000000000000000000000000000000000000000000000000000000000
000000000000000000000000000000000000000000000000000000000000000011111111111111111111111111111111111111111110
000000000000000000000000000000000000000000000000000000000000000011111111111111111111111111111111111111111110
000000000000000000000000000000000000000000000000000000000000000011111111111111111111111111111111111111111110
000000000000000000000000000000000000000000000000000000000000000011111111111111111111111111111111111111111110
000000000000000000000000000000000000000000000000000000000000000011111111111111111111111111111111111111111110
000000000000000000000000000000000000000000000000000000000000000011111111111111111111111111111111111111111110
111111111111111111111111111111111111111111111111111111111111111111111111111111111111111111111111111111111110
111111111111111111111111111111111111111111111111111111111111111111111111111111111111111111111111111111111110
111111111111111111111111111111111111111111111111111111111111111111111111111111111111111111111111111111111110
111111111111111111111111111111111111111111111111111111111111111111111111111111111111111111111111111111111110
000000000000000000000000000000000000000000000000000000000000000011111111111111111111111111111111111111111110
000000000000000000000000000000000000000000000000000000000000000011111111111111111111111111111111111111111110
000000000000000000000000000000000000000000000000000000000000000011111111111111111111111111111111111111111110
000000000000000000000000000000000000000000000000000000000000000011111111111111111111111111111111111111111110
000000000000000000000000000000000000000000000000000000000000000011111111111111111111111111111111111111111110
000000000000000000000000000000000000000000000000000000000000000011111111111111111111111111111111111111111110
000000000000000000000000000000000000000000000000000000000000000000000000000000000000000000000000000000000000