0000000000000000000000000000000000000000
1111111111110001111111111111111111111100
1111111111000000011111111111111111111110
1111111111000000001111111111111111110000
1111111111100000011111111111111001111111
1111111111111001111111111111111001111111
1111111111111111111111111000001111111111
1111111111100000011111111100011111111111
1111111111100000011111111110111111111111
1111111111100000011101111011111011101111
1111111111111111111111111111111111111111
1111110011111001111111000110010111011111
0000000000000000000000000000000000000000