111110111111
111100111111
111000110011
111111110011
110001111111